F 255,0,0
NO    ./textures/greystone.xpm 

C       0,0,255
SO             ./textures/colorstone.xpm
EA              ./textures/mossy.xpm
WE                 ./textures/wood.xpm

1111111
1100011
1100011
1100011                 1111
1100011                 1S11
1100011                 1011
1100011                 1001
1100011                 1011
1100011111111111111111111011
1100000000000000000000000001
1100011111111111111111111011
1100011                 1011
1100011                 1011
1111111                 1001
1111111                 1111
1111111                 1111