


SO ./textures/red.xpm 

EA ./textures/cobble_stone_64.xpm       




            WE          ./textures/eagle.xpm          
C  29,6,75 

F        3,145,25  

NO ./textures/homer.xpm 

11111111111111111111111111111
10000000000000000000000000001
10000000000000000000000000001
10000000000000000000000000001
10000000000000000000000000001
1000000000000000000000000000111111111111111111111111111111
10000000000000000001111111111100000000000000000000000001
1000000000000000001          1000000000000000000000000001
100000000000000000011111111111000000000000000000000000001
100000000000000000000000000000000000000000000000000000001
10000000000000000000000N00000000000000000000000000000001
10000000000000000000000000000000000000000000000000000001
10000000000000000000000000000000000000000000000000000001
1000000000000000000000000000111111111111111111111111111111
10000000000000000000000000001
10000000000000000000000000001
10000000000000000000000000001
11111111111111111111111111111
